tileset_info: ..\assets\tilesets\tilesetIso.png 7 1 64 32
map_dimensions: 15 15
map_data:
411111111111111
022222211222213
023333311333323
023222211222223
023233311333333
123231211221223
123232311232323
123232311232323
123232311232323
123231211221223
123233311333333
123222011222223
123555011555523
122222221222213
111111111111111
